33333333333333333333333333
33333333333333333333333333
00000000000000000000110033
00000000000000000000110033
00000000000000000000110033
44444444444444444411110033
44444444444444444411110033
11110011001111111111110033
11110011001100000011110000
00000000000000000011110000
00000000000000000011110000
00000000000000000000000000
00000000000000000000000000
22225522225522225522220055
22225522225522225522220055
55555555555555555555220055
55555555555555555555220055
00000000000000000000000000
00000000000000002222220000
44444111111110000000001144
44444111100000000000001144
00000000000000000000000033
00000000000000000000000033
00000000000111100000000033
11000000000160100000000011
11000000000100100000000011